el amigo	the friend 	-common use, easy to remember
el banco	the bank	-BANK~BANCO
el baño 	the bathroom	-common use
el carro	the car
el gato		the cat
el hermano	the brother
el libro	the book
el muchacho	the boy
el niño 	the male child
el perro	the dog
el teléfono	the telephone
el vino		the wine
el animal	the animal
el café 	the coffee
el doctor 	the doctor
el hombre	the man
el hospital	the hospital
el hotel 	the hotel
el tomate 	the tomato
el tren 	the train
el clima 	the climate
el día 		the day
el drama 	the drama
el idioma 	the language 	-think "idiom" 
el mapa 	the map 	-in Dora the explorer, the map is male
el planeta 	the planet
el poema 	the poem
el problema 	the problem
el programa 	the program
el sistema 	the system
la amiga	the friend
la blusa	the blouse
la bolsa	the bag 	-picture a bag made of "balsa" wood.Also means stockmarket-"Cuando abrió la bolsa, las acciones habían caído 15 puntos."
la cama		the bed
la casa		the house
la cerveza	the beer
la hermana	the sister
la iglesia	the church
la lámpara	the lamp	-call someone a lamp, it means they're useless. Think "A lamp without a bulb."
la mesa		the table
la muchacha	the girl
la niña 	the female child
la persona	the person
la planta	the plant
la tienda	the store
la ventana	the window
la canción	the song
la conversación	the conversation
la invitación	the invitation
la lección	the lesson
la ilusión	the illusion
la televisión	the television
la ciudad	the city
la verdad	the truth
la amistad	the friendship	-was the slave ship, La Amistad, about friendship?
la actitud	the attitude	-spelled like "acting"
la foto		the photograph
la mano		the hand
la radio	the radio
la clase	the class
la flor		the flower
la luz 		the light
la mujer	the woman	-can be considered impolite if woman isn't old or married
la piel 	the skin	-think "skin peeling"
la suerte	the luck
el artista	the (male) artist
la artista	the (female) artist
el pianista	the (male) artist
la pianista	the (female) artist
el cantante	the (male) singer
la cantante	the (female) singer
el presidente	the (male) president
la presidente	the (female) president
el animal	los animales
la bolsa	las bolsas
la canción	las canciónes
la mujer	las mujeres
un amigo	a (male) friend
un baño		a bathroom
un espejo	a mirror
un jardín	a garden
un museo	a museum
un sillón	an armchair
un tiquete	a ticket
una amiga	a female friend
una biblioteca	a library
una ciudad	a city
una librería	a bookstore	-a "librar-i-a" is a bookstore
una maleta	a suitcase
una mujer	a woman
una página	a page
una persona	a person (male or female)
una pluma	a pen

LOS COLORES
amarillo	yellow
anaranjado	orange
azul		blue
blanco		white
gris		gray
marrón, pardo	brown
morado		purple
moreno		brown-skinned
negro		black
rojo		red
rosado		pink
verde		green
agradable	agreeable, pleasant
alegre		happy	-alegre (the medicine, cheers you up!)
barato		cheap -"¿Es él barato?"
caro		expensive - car without an r
débil		weak
delgado		slender
difícil		difficult
estupendo	terrific
excelente	excellent
fácil		easy
la flaca	the thin woman
gordo		fat
guapo		handsome, pretty
horrible	horrible
inteligente	intelligent
viejo		old
rico		rich
típico		typical
triste		sad
las cortinas	the curtains
grueso		thick
el vestíbulo	the entryway
sencillo	simple
la alfombra	the carpet
azul marino	navy blue
la nevera	the fridge	-there's NEVER anything in the fridge
Mi alcoba	my bedroom
el estudio	the study (room)
cómodo		comfortable 
el ascenor	the elevator
el avión	the airplane (think avion=bird=fly)
el campo	the countryside
el coche	the car
el cuarto	the room (like quartering soldiers)
el dinero	the money
el edificio	the building (edifice, but more so)
el hogar	the home
el mensaje	the message
el ruido	the noise
el teatro	the theater 
el viaje	the trip
la calle	the street
la carta 	the letter
la cuenta	the bill/check
la frase	the sentence
la gente	the people
la guerra	the war
la habitación	the room
la hoja		the leaf
la obra		the play
la medicina	the medicine
la llave	the key
la pared	the wall
la puerta	the door
la salud	the health
la semana	the week
la tarea	the homework
la tarjeta	the postcard
fiel		loyal
suave		soft
flojo		lax (I heard this applied as Lazy)
hondo		deep
libre		free
orgulloso	proud
duro		hard
bello		beautiful
emocionado	excited
probeza		poverty
los premios	the prizes/awards